pUUUUUUUUUj__lUUUUUq,
L__________________R,
L__________________R,
L__________________R,
L__________________R,
j__________________R,
___________________R,
___________________R,
q__________________R,
lDDDDDDDDDDDDDDDDDDj,